EventSouce_pkm -> GiuseppesartoHydrangeaarborescens
DingViewModel_pkm -> FamilyorectolobidaeGnathostomata
SSCSensorsManager_pkm -> PfGreengrocery
SSRevi -> AristidemaillolGovernmentofficials
MineViewModel_pkm -> ArteriameningeaSillyseasonAnimism
SSAppData_pkm -> WoodstorkZoonosis
String+xaDecryptor -> RudaceousrockRhinoceros
SausagecurlSporangiophoreView -> KobuskobSaharaPeppershaker
SSVipStatusRequestUtil_pkm -> SqftUbledagger
SSVipInfoModel_pkm -> NoblesseKenaf
SSUserDataManager_pkm -> PapiermacheTrainticket
SSVipInfo_pkm -> FigureheadDiscountbusiness
SSCProductCommodityDtoListGoodsInfoModel_pkm -> CaloosahatcheecanalReportingweightMastic
SSCProductCommodityDtoListModel_pkm -> CutofporkDelawareTub
SSCProductMemberIosStyleDtoModel_pkm -> FirststateJohannmuller
SSCProductInfoModel_pkm -> MasqueChiococcaalba
SSCProductCommodityGroupDtoListModel_pkm -> RelianceChalktalk
SSCDictionary -> BritanniametalStinterRoyalacademyofarts
Noti -> FallsReaut
SSCDate -> HeiratlawWebmapservice
SSCUIDevice -> DisposalSaddleoxfordSouthchinasea
SSCString -> FluxThermopile
SSCCommonSDKManager_pkm -> YamfamilyRescueoperation
SSCCommonSDKParams_pkm -> FaInpatientAccretion
SSCCommonSDKParamsExtension -> BlabbermouthMesoblast
SSCIDFAHelper_pkm -> QuarterRutGenusepinephelus
SSCAttributeUtil_pkm -> MoodSplenr
CleanVip_pkm -> NaperyInterdependency
AttTracting_pkm -> StepuptransformerTreadHemicrania
BDManager_pkm -> LocalisationprincipleRomanalUgli
SSCApplePurchaseStatusUtil -> AtombombWonderer
SSCPaymentTransactionState_pkm -> GiftwrappingKillercell
SSCVerifyOrderUtil_pkm -> HummingbirdParachuting
SSCApplePurchaseManager_pkm -> PositivedegreeChemicalengineering
SSCApplePurchaseOrderUtil_pkm -> BeholdingReturnticketEvergreenthorn
SSCProductManager_pkm -> ClarkgableMdLincolnsteffens
SSCUploadSABuryUtil_pkm -> CisternLongshotCoprolith
SSCTimerManager_pkm -> CleanupTemporalrelationClod
SSCNetworkConfig_pkm -> LepipterousinsectBanzaiattack
SSCNetworkTool_pkm -> DominicaUneasinessLbf
SSCNetworkMonitor_pkm -> CaretakerDucksanddrakes
SSCRequestHeaderHelper_pkm -> DumuziMessagepadDdi
SSCAPIManager -> TNewburgsauce
UIDevice+ -> ThelephoraceaeMonologue
ProgressHUDWrapper_pkm -> NicenessGoldenstarGoiter
SSCCommon_pkm -> FactorizationTzar
SinussigmoideusMulticollinearityView -> KogiabrevicepsLind
DelightRocketcressStthomasaquinasView -> AirscrewXanthicacidLeaselend
CrossingSlatternUreaView -> HerbDriftageUnfinishedbusiness
PleurisyDrinkingchocolateView -> RhinocerosantiquitatisOrstopper
BrennerpassHereticView -> SlavicpeopleBurgrass
CrystalsetDirhamView -> WeaselwordLamentNegroid
CharredpancakecupCommitmentView -> TomturkeyDespatch
RelocationAscendencyOrganizationView -> ThanatophobiaDealSuedeleather
WayfaringLogrollingView -> DepressionVietnam
GenusbranchiobdellaDeviationismFileView -> AscendentCornflowerTwinkle
DeviationistRhizopogonidahoensisBlankView -> MorphallaxisClarinettistEconomicrent
MinstrelshowLipisisSaltwortView -> FalloutBlazeOpensandwich
DrymouthWhorledloosestrifeSpecialismView -> JudgmentFuraneN_newbrunswick
DysgenicsRuleView -> MuskusgrassDivisiondicynontia
CoalindustryAdvancerIndividuationView -> PouteriazapotaWarrenRecapitulation
ConflictLoxostegeUltimatenessView -> StonecressPyrrhocoridae
DisfavourMountainlilyView -> FinisherGlucocorticoidEndrun
LivingstoneAsphaltView -> FloatingmossEntropy
TrifoliumpratenseAmericiumPieceView -> AmbystomatidaeNagi
MultiplicityTearoseView -> On_offswitchSatinstitch
CelibacyFloatingfernWinView -> BorshMetroptosisFootstool
WildparsleyKismatSylvilagusView -> ParidaeFrankfurter
TanacetumpartheniumMysterynovelView -> RealizationMineralwaterGenusrosellinia
BattlelineChemicalphenomenonView -> TorearTractortrailerFealty
FamilylimacidaeDecantationSolitaireView -> HadithColbertbutterJerusalem
SessVelvetleafView -> CalligraphySomaticsensation
HouseholdlinenTricepsbrachiiView -> IngredientBaconandeggsEstrangement
HearsayruleSortingJeanlouisrolpheagassizView -> LimpetMckinleyResorthotel
DudGenusexacumView -> AdjusterShtick
HarvestVictorhortaGabardineView -> PureimaginarynumberCoronachSarcostemma
EnrichmentCucumissativusView -> StripedbassParatrooper
BeriaListprocessinglanguageView -> IncompletefractureAppointmentbook
MandiocaGraphicsView -> FinnishmonetaryunitWheel
FrankfurtonthemainPostitCarnivoraView -> SirfrancisbaconDyeingPerciformes
ConcurrenceInattentivenessWeltanschauungView -> YelpMurraygellmannContainership
CasablancaWantedposterBlairView -> LodestoneScheme
LiopelmaOpeningChlorophytaView -> HomonaCitrusfruitTung
AbacaWhistlerCephalhematomaView -> ChinawareTercelet
HinduismTeiidPiranhaView -> MadamSepticsorethroatShading
BlitzsteinMaidenhairtreeFibreopticcableView -> GodRadiostationBranchedchainketoaciduria
LunacyEnvoiView -> ConyzaApex
MalemonarchMarcusanniusverusBallyhooView -> ToulonFecundity
BauxiteMarshgasHemingView -> BastardridleyTaxpolicy
SouthplatteriverLeitneriaHymnodyView -> BillionthSamiawalkeri
PinenutClassicalmusicEffectsView -> PedwoodFather
DiscountratePoliticalrelationShearsView -> IonexchangeFlushtoilet
AviaryWordstructureView -> NonpaymentKenafJohndeere
KilotonMaritalcommunicationsprivilegeView -> MaterielQuadragesima
MartyniaannuaBlastocladiaSpinachblightView -> FlyintheointmentColpocystitisGilbert
PotatofungusWatergasNitrousbacteriumView -> CivilisationTearsacJapaneseredarmy
RoaldhoffmannRetroversionView -> PegSuspension
EuglenophyceaeFixationView -> CartonDahliapinnataSafetyfactor
StanselmBloodgroupSophistryView -> WaveDifferentiation
FelineHabenariabifoliaView -> GreenhornProterozoiceonSimpleness
PlacekickDelawareView -> LinebackerTurniprootedparsleyStock
SatyendranathboseSouthdakotaGenushedeomaView -> FeastdayRapineAcetanilide
HarlowSeineHanverView -> ShinerGenusrhyncostylisCubancapital
CrabappleSeaView -> IronfoundryCaloosahatcheecanal
NoveltyshopSwitcherooHospitaloccupancyView -> BellyReverseGundeck
QuercusgrosseserrataOverstrainView -> StaghornfernSandwichboardCircumvention
EpauletOverappraisalCocksuckingView -> MyringectomyEpeeSymphilid
AlcidesCrawfordView -> AggressivenessWateringcan
CanadianfallsGenusgymnadeniaBlackwashView -> InsolenceFloridapompano
GoosebarnacleDroguechuteView -> CapepasseroRutShan
TrichosurusvulpeculaFavouritismInachisView -> OutcroppingHydroxytetracyclineVegetation
TeetertotterFulminicacidView -> OrgannorSidechapel
HeadStartingmotorComputercodeView -> ToterNerveagentMusket
ZirconConscienceView -> SingleleafpinyonReassemblyManhole
VonwillebrandsdiseaseChitMadagascanView -> GenuspetromyzonStreptosolen
MicrotTeresminorView -> XiiiAbatablenuisancePhascolarctos
RappahannockRepublicofnauruCheerfulnessView -> CoigneHighnoonHeroicpoetry
AlismalesOblongnessView -> SiouxcityHypoplasticanemia
WorktableEmendationRetardationView -> UnwillingnessRetardedMenu
LymphocyticleukemiaPrintingView -> GenussideritisShrinkageRajalaevis
FalsevampireRegressionCocktailloungeView -> GreekfretBokchoi
BarlineMarylandchickenView -> AeoliaOldfaithful
MedicaldiagnosisSonantView -> WeirTitfer
MillstoneFacialRavisherView -> MomentGenuscistothorus
CeltuceBufferinView -> CallisaurusMishegaasGramsprocedure
CalfCarcinomaView -> PalenessChinaberry
ParamilitaryPaganreligionLineamentView -> HallPaidvacationNavane
NoparstockPilotchartView -> PrimnessTarmacadam
WebLavandulaKingmofthenetherlandsView -> HeadshipLouisxiiiMagnetomotiveforce
AccountingsystemNasturtiumfamilyView -> FreshnessAzuriteStellite
MegalithPolemoniumcaeruleumBaseView -> PolygamySouthernscupLothringen
PessimistOutpouringView -> EyepatchKrishnaWear
FelixkleinSeparationFaunaView -> LagMonacoNazareth
HydrazoicacidCompassplantView -> AnglosaxondeityMyosis
JumadaiiSoundpollutionView -> WinfieldscottFragmentation
RegimeHolyoilAdelgesView -> StrophariarugosoannulataCoveredbridge
MarkettownMandibleView -> NarrowgoldenrodDiplomacyBlowtube
SierraRootcellarView -> SaintnicholasWatercolourPoacher
SatrapSlicingWilliamshakspereView -> BowElectronspinresonance
OiltycoonPestisbubonicaPopularitycontestView -> DigitalvoltmeterSamuelhouston
DescendingnodeResearchprojectView -> QualifyingTripper
GenusdrypisCourtierView -> WnrightnessBeefbourguignonneKillzone
TaupeBorgiaTupackatariguerrillaarmyView -> SalixhumilisHolyoilCoattail
GenuspresbytesLaundrytruckSableView -> CentreofflotationBirdStraightfluteddrill
MoharramBelgianfrancView -> SpecialFelisbengalensis
TwinkleConverseView -> TradesecretGhostlinessEuropeansanicle
TTBuild_pkm -> GenusontoglossumPedilanthustithymaloides
TTBuildProtocol -> WiltBroadjumpMorbidity
SSCGlobalData_pkm -> MainstreamPlainslemonmonarda
SwiftyJSON -> RhosphaerarhodanthemaNorthernboglemming
Alamofire -> FamilymarantaceaeDoctoroffinearts
ParameterEncoder -> TrumpetflowerRanitidine
Session -> FieldmousePotentiometerIllservice
Protected -> FoolsparsleyFogginess
ParameterEncoding -> MaidFilmfern
AFError -> PsychologyBaptistsRedstart
DataStreamRequest -> SenseofhumourMortarMammilla
DownloadRequest -> ViscountnelsonSirfrancisgalton
WebSocketRequest -> AlaskapeninsulaIdentikitEchinodermfamily
HTTPMethod -> CanterburyPlague
URLConvertible+URLRequestConvertible -> SynovitisClangula
RequestTaskMap -> SalmagundiLymphangitis
Notifications -> ParticularbaptistSubclasssynapsida
Response -> SnifflerGenusarchosargusEmigrant
Request -> MarriageceremonyWarchestFile
HTTPHeaders -> QuinceTollerFomesigniarius
DataRequest -> PressuregaugeDaylightGenusacritheres
UploadRequest -> PasChrysemys
SessionDelegate -> HalenessTyphusfever
MultipartFormData -> GayliberationmovementSynthesisLoser
RequestInterceptor -> HydrophobiaCraftiness
NetworkReachabilityManager -> NeedlepointDracaenaceaeFeudallordship
Concurrency -> NeolatinGenushydrilla
CachedResponseHandler -> ReflexiveverbKerryblueterrier
RetryPolicy -> TaoistSharpieGustavklimt
ServerTrustEvaluation -> GenusvedaliaChordeilesBrixscale
RedirectHandler -> CalcuttaCheilanthesgracillimaSaudi
URLEncodedFormEncoder -> SugarshellSciaenidaeImpermeability
AlamofireExtended -> WallpellitoryLawofchemicalequilibrium
MultipartUpload -> ElectionQuicknessJapan
Validation -> GravestoneHyperchromicanaemia
AuthenticationInterceptor -> FallAprilfool
EventMonitor -> ThongForm
Combine -> PrefixCerastium
RequestCompression -> AlnusveridisLongtailedweaselBradawl
ResponseSerialization -> VenditionReptiliaGalicia
URLSessionConfiguration+Alamofire -> SymbololatryDeflexion
OperationQueue+Alamofire -> GenuszenaiduraMoss
StringEncoding+Alamofire -> UblesaucepanTelephoneextensionZanegrey
DispatchQueue+Alamofire -> AcrilanGolgiscell
URLRequest+Alamofire -> DibsAlkeran
Result+Alamofire -> WealthypersonGenusmasticophis
SKProductExtensions -> PorterStatutemileVictualer
WKWebViewExtensions -> LeagueWalker
CGRectExtensions -> BaseHaroldiiStrawboard
CGFloatExtensions -> JetbridgeFlipflop
CGVectorExtensions -> ClincherResistanceCounter
CGSizeExtensions -> TrespassdebonisasportatisGenusthrinax
CGAffineTransformExtensions -> HandcuffPartnershipCombatmission
CGPointExtensions -> GenussynchytriumTatar
CGColorExtensions -> AmanRemembrance
HKActivitySummaryExtensions -> FlourishBallbusterPyxidantherabarbulata
UIBezierPathExtensions -> GenusmacroclemysMicroscopeslide
UISearchBarExtensions -> GreatsolomonssealTrackMontegobay
UITableViewExtensions -> CharterPalilaliaWilliams
UIScrollViewExtensions -> GypsOrderaristolochialesGlass
UITextFieldExtensions -> CheckAegina
UILayoutPriorityExtensions -> HarrisDiskoperatingsystemHomeless
UINavigationItemExtensions -> PrairieckSnorkelbreather
UIStackViewExtensions -> FigwortApe
UICollectionViewExtensions -> InferiorcourtCoachTelophase
UITextViewExtensions -> CherrypepperPterygoidprocessAsymmetry
UIBarButtonItemExtensions -> OrbiculateleafStump
UIStoryboardExtensions -> BounderNegativeMarriageproposal
UITabBarExtensions -> StampedeParsdistilisNightletter
UISegmentedControlExtensions -> MaewestLachesisGhobble
UINavigationBarExtensions -> WasteRenalcalculus
UIActivityExtensions -> PediculuscapitisNurseHaitian
UISliderExtensions -> PowerhungerKnowing
UIViewControllerExtensions -> ExposureMustardplaster
UIImageExtensions -> TrepanUnionsoldier
UINavigationControllerExtensions -> SubclassrosidaePreciseness
UIViewExtensions -> RadiolariaDesertrose
UIGestureRecognizerExtensions -> ThrongGator
UIWindowExtensions -> HistoricperiodPinkofmyjohnDj
UILabelExtensions -> RoometteDip
UISwitchExtensions -> AsuraBacknumberFrail
UIButtonExtensions -> OdiousnessSubstantialnessTopology
UIApplicationExtensions -> FourpartharmonyRealitycheck
UIImageViewExtensions -> PixReddaggaPock
UIRefreshControlExtensions -> LivonianOahuislandEasterbunny
UIAlertControllerExtensions -> TriiomethaneUnitofammunition
UIFontExtensions -> MoldboardSaddleback
UIColorExtensions -> ReleasinghormoneWitchhazelplant
UIImageViewDeprecated -> BiddingDeflation
DispatchQueueExtensions -> GenuscoprinusHypotheticalimperative
SCNShapeExtensions -> MainframeCasernTuatara
SCNSphereExtensions -> GenusdusicyonSpringcankerworm
SCNBoxExtensions -> OccipitallobeWriterscramp
SCNGeometryExtensions -> ProductionNervefibre
SCNVector3Extensions -> EpitaxyTongaRipariariparia
SCNCylinderExtensions -> BodyofwaterVestal
SCNMaterialExtensions -> CytolysinBarklouse
SCNPlaneExtensions -> CrusPromiserFishtailpalm
SCNConeExtensions -> DouglassFreshfoods
SCNCapsuleExtensions -> ScaupduckEmpennageCharlesherbertbest
NSPredicateExtensions -> WinwwasherStaticline
NSRegularExpressionExtensions -> ProsceniumarchPelliculariakoleroga
UserDefaultsExtensions -> MastiffbatKingsalmonGenusrana
DataExtensions -> PsilophytalesThujaoccidentalis
URLRequestExtensions -> PaperplantLost
FileManagerExtensions -> ConstantquantityTorpetube
NotificationCenterExtensions -> GenuspaeoniaMonsEpilobiumhirsutum
URLExtensions -> DevilsweedBruceGlazer
LocaleExtensions -> JazzbandExoergicreactionBoneoil
MeasurementExtensions -> JosephlisterPinaforeFalselilyofthevalley
DateExtensions -> VenaobturatoriaDarkMinion
NSAttributedStringExtensions -> DeltawaveGentlemanjimAlcoholicdementia
CalendarExtensions -> RedgumGenusfundulus
EdgeInsetsExtensions -> ButylnitritePakistani
FontExtensions -> SchistosomaLouisxivLycopodiumlucidulum
ColorExtensions -> RighthanderGunplay
SKNodeExtensions -> FirebrickAnnouncement
SKSpriteNodeExtensions -> CantharelluscibariusWilderness
MKMultiPointExtensions -> GarciniagummiguttaTriskelionIndigofinch
MKMapViewExtensions -> NemophilamaculataMissionary
MKPolylineExtensions -> BemidjiRelegation
DigestExtensions -> SmackingSmewListon
SignedIntegerExtensions -> ParalepsisSoftyFamilycordaitaceae
BidirectionalCollectionExtensions -> CanonlawChildbedfever
ComparableExtensions -> MrifleBlurriness
ArrayExtensions -> KirpanSonPorzana
StringProtocolExtensions -> GenuschlorococcumBraxtonhickscontraction
BinaryFloatingPointExtensions -> GenusepinephelusSuperfamilysphecoidea
FloatExtensions -> MommyAirmedal
DefaultStringInterpolationExtensions -> TasterGeodesic
KeyedDecodingContainerExtensions -> AesculushippocastanumTantalus
SequenceExtensions -> TatMiscalculationConopodium
MutableCollectionExtensions -> InsurgentSaintfrancisxavier
SignedNumericExtensions -> HootFifthcranialnerveDepositary
DictionaryExtensions -> BadlandsStrangenessDeathcap
StringExtensions -> SelfconfidencePlasticbagDuluth
DecodableExtensions -> OaxacaOpacificationDaybook
BoolExtensions -> SewerageMarket
DoubleExtensions -> SquirtDodgson
CharacterExtensions -> HeritagePerilymphFurnariidae
FloatingPointExtensions -> IntelligenceagencyDoc
IntExtensions -> MusculusdeltoideusQuixotismLargenumber
RangeReplaceableCollectionExtensions -> BullmarketCeibapentandra
OptionalExtensions -> AquaregiaTransportationPcp
CollectionExtensions -> KlansmanSquelcherSeriema
BinaryIntegerExtensions -> SweetlemonSeleniumcellBushel
CLLocationArrayExtensions -> PsidiumlittoraleCasimirfunk
CLVisitExtensions -> LaminariaWire
CLLocationExtensions -> FaradayDelawareAlanmathisonturing
NSColorExtensions -> HeimdalPlasmathromboplastinantecedent
NSStackViewExtensions -> WharfratVenabulbipenis
NSViewExtensions -> LotariodisegniFelodeseLitmuspaper
NSImageExtensions -> InitiationNeckbone
CAGradientLayerExtensions -> LowarchipelagoFestering
CATransform3DExtensions -> RefinementNote
AES -> UtXGenusocoileus
StreamDecryptor -> ArteriaalveolarissuperiorIbnsina
BlockEncryptor -> IncumbranceKingmofdenmark
UInt64+Extension -> OrpheusCarissaAcores
Cryptors -> ClawSegmentationFruitsalad
HKDF -> AggeusGenusaegypius
ISO10126Padding -> EristicVigeelebrun
Cipher -> PsidiumguajavaSphecoidwasp
CBCMAC -> QuechuanlanguageDinnerbell
Int+Extension -> KingmBrittlefern
AES.Cryptors -> LimenGymnocarpiumdryopteris
Bit -> GasolinegageFuzziness
HMAC -> SurveillanceofdiseaseBreakingawaySheet
CMAC -> TyphalatifoliaNarcissusWintergreenoil
UInt16+Extension -> CommiphorameccanensisSkillfulness
Collection+Extension -> BullWorkingpersonCorynebacteriaceae
XChaCha20 -> InternationaleGenusmarchantia
UInt32+Extension -> MushroomcloudPycnidium
Digest -> FuseeFormativecellAlveolarresorption
UInt128 -> BookscorpionArticulatioplana
Scrypt -> GreendragonBorisspassky
NoPadding -> LagostomusProstatitis
UInt8+Extension -> SheepsorrelHeliothisziaDeposer
MD5 -> InigojonesCounsellor
Cryptor -> CollectorCredenceMyrdal
CompactMap -> ValleypocketgopherWatercolorist
BatchedCollection -> VolleyballnetSep
ISO78164Padding -> ReservationReedrhapisLockage
SecureBytes -> TimekeeperWilliamofoccamMountaintent
Signature -> PalletChuckwagonMpeg
ZeroPadding -> QuercusprinoidesLightnessComanche
String+Extension -> SymphonySuperpositionprinciple
Authenticator -> AbductionGenusholbrookia
SHA3 -> CowtownGenuscaltha
Operators -> SforzanMaillot
Rabbit -> RenalcorpuscleMalpighiaceaeScyphus
SHA1 -> BohriumRhantibodyMarchantiapolymorpha
Poly1305 -> EconomicprocessAbreaction
BlockCipher -> GenussebastodesPartyofgod
Updatable -> FlareAlveolarconsonantUrals
Blowfish -> StraddleSiren
BlockDecryptor -> SosHireling
StreamEncryptor -> SkegBeantown
DigestType -> FocusDesign
Utils -> PeasantBeetleweed
Generics -> WhereaboutsRap
Checksum -> OchoaGraceFaultfinding
SHA2 -> UnevenparallelbarsCorrespondenceschool
Padding -> RoguenationBacksword
ChaCha20 -> SciurusOvercast
Array+Extension -> GradeschoolLanaiisland
ASN1Scanner -> GowencypressRhea
ASN1Encoder -> GentianaacaulisDebasementDependence
ASN1Decoder -> BitisgabonicaChapterLoaning
ASN1 -> ArgasidaeConsecrationInstigation
DER -> SuctionGenusrubiaSaleslady
AEADXChaCha20Poly1305 -> IndulgenceLutzen
AEADChaCha20Poly1305 -> GenushesperisCowboyhatZinniagrandiflora
AEAD -> IndemnityDerailmentMoulding
RSA -> QuagAmerigovespucciIrritation
RSA+Signature -> PeccaryPunchbowlCorianderseed
RSA+Cipher -> KaiappleYardgoodsDraftsperson
String+FoundationExtension -> VelleityImpulsionHeartburning
XChaCha20+Foundation -> DeckchairAffirmativepleadingSaddleroof
Blowfish+Foundation -> KitchenapplianceGenusdoliolumAlternation
Utils+Foundation -> GrizzleSolaceHulahoop
HMAC+Foundation -> TrotskyismSwagBattleofzama
Data+Extension -> AspiphoroidesAaronmontgomerywardSteamer
ChaCha20+Foundation -> WomansclothingLuckydip
Array+Foundation -> HandbreadthCleavageTimeloan
AES+Foundation -> GolcondaBison
Rabbit+Foundation -> NitrogenAnemonecylindrica
PKCS7Padding -> ScrewbeanmesquiteFess
PKCS5 -> DameellenterryHudsoniaericoides
PKCS7 -> TailedtoadStripmining
PKCS1v15 -> FlyBehaviorismSoutherncrabapple
PBKDF2 -> TranscendentalistSatanism
PBKDF1 -> KnotgrassAutogenics
BlockModeOptions -> LightyearNaemorhedusgoral
OCB -> AirrifleNewtonianreflector
CFB -> SymphytumofficinaleMegabyte
CBC -> DonatusPineappleweedCitrusgrandis
ECB -> RealtimeoperationChino
CCM -> GreendragonAlnusincana
PCBC -> ChemistsshopAlopexlagopusTympanist
BlockMode -> MustachecupTurtleDjiboutian
GCM -> BootmakerShavuoth
CipherModeWorker -> ChineseelmTinea
CTR -> RemembrancesundayNicheMesabirange
OFB -> MarshGenuspantheraGroundselbush
Random -> WarlordCaliforniaboxelder
GCD -> AcidemiaCaliforniawhiteoak
Hashable -> SuggestionAliterateperson
Strideable -> HoursLoupe
DataConversion -> BantamweightMedanHiringhall
Addition -> AirplanepropellerWesternlarch
StringConversion -> NorthwardInitialoffering
Comparable -> LythraceaeFlankerbackLargeintestine
WordsAndBits -> ShadPapaverargemone
IntegerConversion -> BirdcallAdsorptionFloorlamp
Division -> DisgustingnessKontiki
PrimeTest -> FamilybacillaceaeLivonian
Codable -> BlanketCharlesmauricedetalleyrandBlowjob
SquareRoot -> GalangalHipCivicspirit
BigUInt -> JuggernautGenusscincus
BitwiseOps -> AmbrosiatrifidaTrust
Multiplication -> AlmaataTuathadedanannLiving
CS -> MasterofartsDalianAutomatictellermachine
Exponentiation -> PaperbirchSelarMyroxylonpereirae
Shifts -> EnchantmentVoicer
Subtraction -> WormwoodHershey
BigInt -> ArtillerymanStunnerMidnovember
FloatingPointConversion -> ForkAnrranSteprelationship
ReflectionHelper -> LoonWellerism
Metadata -> ParameterTeacakeWristband
CustomDateFormatTransform -> MrifleFostersonEdwardtheconfessor
Properties -> CamisePrangTanoan
HexColorTransform -> CorynebacteriumdiphtheriaeAgalactosis
Transformable -> XhosaTetriPorkandbeans
PointerType -> PotlikkerHomeoboxImperialcapacityunit
Logger -> TahokadaisyBoost
MangledName -> WomaniserYvestanguy
ExtendCustomModelType -> JuggleryReactionIntelligenceanalyst
Measuable -> TackleQuestiontime
ISO8601DateTransform -> PolymorphismKalumpangFeverfew
Export -> HepatolenticulardegenerationNeology
URLTransform -> MultiplexBerlioz
NSDecimalNumberTransform -> PeasantryLeonberg
ContextDescriptorType -> SchlepperPurification
EnumTransform -> RedcoralAnamnesis
CBridge -> PushwnlistDefensesecretary
FieldDescriptor -> DunghillCommonduckweed
BuiltInBasicType -> GridmetalCarpark
OtherExtension -> PrevisionCraze
Deserializer -> LernerButtonpink
DataTransform -> KoasatiFundulusmajalis
BuiltInBridgeType -> SnatchProgesteroneHalfhitch
HelpingMapper -> ChristianscienceOldbulgarianTeabiscuit
AnyExtensions -> AoristLowerrespiratorytractsmear
EnumType -> ShotgunHijackerCharioteer
TransformType -> PusslyRefluxLanguage
DateTransform -> IrradiationKitchen
PropertyInfo -> PterostylisVotePoliticalliberty
DateFormatterTransform -> StagnancyResuscitatorDrjohnson
Serializer -> BerkeleyShark
ExtendCustomBasicType -> SubbaseGenusmacrodactylus
TransformOf -> ZerocouponbondMilesdavisJosephus
Configuration -> CedrelaorataTailfin
Config1 -> IsaraduncanKopiykaWilkesland
DelegateHelper -> BambuseaeMelospizaMaori
